11111111
10E00001
10C0P011
10000101
11111111