11111111
10000001
10C0E011
10000101
1P00C011
11111111