111111111111111111111111111111111111111111111111
111111P10000000000000000000000000000000000000001
111110010000000000000000000000000000000000000001
111100100000000000000000000000000000000000000001
111001000000000000000000000000000000000000000001
110010000000000000000001000000000100000000000001
10010000000000000000001C10000000000C000000000001
101000000000000000000000000000001000000000000101
100000000000000000000000000000000000000000001001
10100000000000000000010000000000000000000001C001
10010000000000000000000001000000000000000001E001
110010000000000000100000C0000000000000000001C001
111001000000000000000000000000000000000000001001
1C1101000000000001000000000000001000000000000101
101100100000000000000000000000000000000000000001
100110010000000000000001C00000000000000000000001
1101110010000000000000011C000000C000000000000001
10C0C010110000000100000111C000000000000010000001
10C0C0100110000000000001111C000000000000C0000001
10C0C01000111101111111011111C0000000000000000001
10C0C0001000000C111111C111111C000000000000000001
111111111111111111111111111111111111111111111111